abort - abr
about - abt
arrow - arw
blank - blk
bracket - brkt
body - bd
breadcrumbs - brcr
button - btn
category - cat
class - cls
close - cl
collapse - coll
color - clr
content - cnt
continue - cont
control - con
controller - ctrl
count - cn
current - cur
deselect - dslt
directory - dir
discrete - disc
empty - mty
expand - exp
field - fld
footer - ftr
fullscreen - fscr
function - func
group - grp
header - hdr
heading - h
icon - i
inner - inr
layout - lo
light - lt
lines - lns
list - l
listing - lst
location - loc
message - msg
namespace - ns
notification - notif
number - num
option - opt
output - o
panel - pnl
parent - prt
popup - pp
processed - procd
query - qry
reconnect - rcnt
reload - rld
reset - rst
result - rslt
right - rt
screen - scr
search - srch
select - slt
selected - sel
short - shrt
sidebar - sb
stack - stk
status - sts
template - tpl
text - t
title - ttl
toggle - tgl
toolbar - tb
total - tot
trace - tr
upgrade - upg
version - ver
waiting - wtng
